**X******X******X***XX****************X**X***X*******X***************X*X*XX******X*****X*X*****XX***
X**X*X*XXX*XX*X*X*X****X*XX*X*X*X*XXX***X**X**X*X*XX*XXXX*X*X*X*X*X*X*******XX*XX**XXX*****XXX****X*
**X**X*X****X**X***XXXX****X**XX*X**X*X***X**X**X*XX*****X*X**XX**XX**XX*XXX*X****X***XX*XX***XX*X**
X**X*X***X*XXX***X*X***XXX*XXX****X*X**XXXX*X**X****XXXX*X*X*X***X***XX*X*****X*XX*X*X**X***X***X**X
*X**XX*XX***XXXXXXX**X***X*****XX*X***X****X**X**XX*X****X***X*XXX*XX***X*X*X**X******X**X*X*X*X**XX
**X*X**X**X**X***X**X*XX*X*X*XX*X**X*X**XX*X*X**X***X*XX*X*XX**X***X**XX**XX*X**X*XXX**X*X*X****X**X
*XX**XX**XXXXX*X***XX**X*X**X*X**X**X**X*X***XXX*X*XX***X**X**X**XXXX****X****X***X*XX*X****XX*X*X**
***X***XX*X*****XXX***X***X*****X*X*X*X***X*X****X*X**XX**X**X*X***X**XXX**X*X*X*X*****X*X*X***X**X*
*X**XX******XXXX****X*X*X**XX*X***X*X**X*XXX**X*X**X*X***XX*X***XX*X*X***X*X***X**XX*X*X**X**X***XX*
**X***XXXXXX*****XX**X**X*X****X*X**X*X***XX*X**X*XX*X*XX*****X*X**X***X***XXX**X***X***X**X**X*X***
X*XXX********X*X*XXX**X**X**XX**X**XX**X*X****X*X*X**X***X*XXX**X*X*X*X*XXX***X**XX**X*X**XXX*X*X*X*
XX****XXX*X*X*X***XXXX**X**XX*X*X*XX**X**X*XXX****X*XX*X**X***XX**X**XX*****XX**X**X*X**X**XX*X*X**X
X**XXX**X**X***XX**X***X*XX****XX****XXX*X*X***X*X****X**X**X****XXX***X*XX*X**X*X*X**X**XX***XX*X**
**X***X***XX*X***X*X*XX*****XX***XX*X*X**X*XXXX***XXX***X*X**XXXX*X**X*X**X***X*****X**X****XX*****X
*X**X***XX***XXX*X*X****X*XX*XXX*X**X***X******X*X***X*X***X*X**X***X**XXX**X*XX*XX*X*X**XXX***XXX**
**XX*X*X***XX**X**X*X*XX*X*****X*X*X**X**X*XXX**X**X**XX*X***X*X**XX**X***XX****X***X*X*X****XX***X*
X*X***XX*X****X**X***X****X*XX*X*X***X*X**XX***XX*X*X*X**XXXXX***X*XX***X*X**XX**X*XX**X**X*X***X*X*
X***X****X*XXX**X**X**X*X****X*X**X*X***XX***XX***X*X***X******XXX***XXXX**XX**X*****X**X**XX*XXX***
**XXXXXX**X****X**XXX**XXXXX*X**X*XX**X*X**XX*X*XX***XXXXXX*XXX****X*****X***X***X*X*X*X*X*X*****XXX
*X**X***XX**XX***X*X*X*XX***X**X*****X**X*X***X**X*X****X***X*X*XX**XXXX**XX**XX**XXX****X*XX*X*X***
***X**X****X**X*X****X****X*X*X*XXX*X**X**X*X***X***XXX***XX***XX**X****X*X*X***X**X**XX*X***X*X**X*
*XXX*X*X*XX*X**XX*X*X*XXX*X***X****X**X*X***XXXXX*X***X*X*X**X****XX*X*XX****XX*XX**X***X*XX****X*X*
X****X**X****X****X******X**X*X*XX*X*X**X*XX*****X**XXX**X**X*X*XX***X*X*X*XX*X***XX*XX*****X*X***X*
**XXX*X***XX*X*XXX*XX*XXX**X*XX**X***XX***X**X*X*X*X****X**X***XX**XX****X****X*X*******XX*X*X*X*X**
*XX****X*X***X*X***X**X***X****X*XXXX*X*XX**X*XX**X**XXX*X***X***X*X**XX**XX*X***X*X*XXXXX*X***X*X*X
*X**XX****X*X**X*X**X*X*X**XXX*X****X*X*X*X*****X***XX****XXXXXX*XX**X*XX*X****XX*X*X***X**X*X**X***
**XX*X*X*X**X*X**XX*X***X*X****X*XX*X******XXXX*X*XX***X*X***X****X*X***X**XXXX*******X**X****X*X*X*
X*X***X**X*X**X*X*X*X*XX*X**XX**X*X*X*XX*X******XX***XX**X*X**X*XX**X*X***X***X*XX*XXXXX**XXXXXXX*X*
**X*X*X*X**X*X**X****XX****XX*X***X*XXXX**XXX*XX***XXX**XX**X*X*X**X*X**XX**X***X*X***X**X****X***X*
*X**X*X*X*X**XX*XX*X***XX*X***X*X*X***X**X***X**X*X***XX***XX*X***X**X*X*X*X*X*X****X*X*X**XX***X**X
*X*XX*X*X***X*****XXXX*X**X*XX***XXXX**X*X*X**X*****X*X**XX****XXX*X***X***X**XX*XX**XX**X*X*XXX*X**
***X**XX**XX*XXXX**X*X***X***X*X**X**X**X**XX**X*XXX****X***XXX******XX*X*X*X******X****X**X***X***X
*XXX*X***X******XX*X**X*X**X****XX**X*X***X**X**X***XX*X*XX****X*X*XX***X***XXX*XXX**X*XX*X*X*X**XX*
*X***XXX**XX*XX**X**X****X*XXXX****X***XXXX*XXX***X*X**X***XXX*X**X***X*X*XX***X***XX*****X***X*X***
*X*XX***X**X**XX**X**X*X**X****X*X***X*X*****XXXXX**X*X**X***X*XX*X*XX**X*X**X***X***XX*X**X*XX**XX*
*X*X**X**X**X***X*XX*X**X*X*X*X*X*XX**X**X*X**X***X*X*X*XX*X*X*****X***XX***X*XXX*XX***X*XX**X*X*X**
*X**X**X**X**X*X***X**X**X**X*******X***XXX*X***XX**X**XX**X*XXX*X***X***X*XX*X*****XX*****X***X***X
**X**X**X**X***X*X**X**X**X*XXX*XX*X*XX**X***XX**X*X*X****XXX***X*XXX*XX**X****X*X*XX*X*XX*X*X**XX**
*XXX***X**X*X*X*X*X**X*XX*X****XX**X*X**X**X**XXX**X**X*X**X**X*X*******X*X*XX*XXX*X***XXX**XXX*X**X
**X**XX*X****X*****X*X***X*XX*X***X**X*X**XXX*****X**X**XXX**XX**X*X*X*X**X**X*******X**X*X**X****X*
*X**X****X*X**XX*XX**X*X***X**X*XX**X**X*X*X*XXX*X**XX*X****X**X*X*X**X**XXX**X*XXX*X*X****X**X*X*X*
X**X**XXX***X*X***X*X*X**X***X**X*X***XX*X******X*X****X*XXX**X**X**XX**X*X**XXX**XX****XXX*X*X**X**
**X**X***X*X**X*X***X***X*X*XX*X**X*XX****X*XXX*X*X*X*X**X**X***X*X**X*X****X*X**X***XXX******XX*X*X
*X**X**X**X**XX**XXX*X*X***X***X*X***X*XXX****X***X**X*X*X*XX*XX**X*X**X*X*X****X**X*X***XXXXX***X**
*XX**X**X***X***X*****XX*X*X*XXX**X*XX****XXX**X*X**X****X****X*X***XX**XX**XX*X**X**X*XX****X*XX*X*
***X**X*XXXX**XX**XXX****X***X***XX***XXX****X**X**X**XXX**XXX****X***X***X*X****XXXX**X*X*X***X****
X*XXX*X****X*X***XX**XXXX*XXX*X*X***X*X**X*X**X***X**X***X*X**XX*X*XXX*XX***X*XX*XX***X****XX*X**X*X
X**X***XXX*X**XX*X**X*****X***X***XX*X**X*X*X*X*XX**X**X*X**X**X*X*******XXX****X***XX*X*X***X*XX***
**X**X*X*X**X*X**X*XXXX*XX**X***XX*****X****X**XX**XXXXX**X**X****X*X*X*X**X*X*X**XX***X**X*X****XX*
*X**X**X**X*X***X**XX****X*XXXXX**X*X*X**X*X*X***X**X***X**X*XXXX****XX***X***X**X*X*X*XX**X**XX*XX*
*X*X**X*X*X**XX**X****XX*X**X***X****X**X*****XX*XX***X**X*X*****X*X***XX***X**X*X***X***X***X*X****
*X**X***X*X*X***X**X*XX***X*X*X***XX*X*X**X*X*X****XX**X*X**XXXX*X**X*X**XXX*X*X**X*X*XX**XXX***X*X*
**X**X*X**X*X*XX**XX***XX*X*X**X*X*X*X*X*XX*X**XXX*X**XX**X****X**X**X**XX***XX**X**X*X*X***X*X**X**
X*X*X****X**XXX**XX*XX**XXX*XXX**X***X*X***X**X****X*X**X*X*X*X**X*X***XX**XX***X**X****X*X***X*XX*X
**X*X*XX*X*X***X*****XX********X*X*XX**XXX*XX*X*XXX****X**XX***X*X**XX*X**XX**XX**X**XX*X**X*X*X****
*XX**X*X*X***X**XXXX**XXXX*XXX*XX**XX*X**X***X**X*X*X*X**X*X*XX***X******X***X**X*X*X****X**X****XX*
***X*X***XX*X*X*X****X****XX******X***X*X*XX***X***XX*X*X******XX*X*XXXXXX*XX*X***X*X*XX*XX***XXX**X
XX*X**X*X**X**X**X*XX**XX*X**XX*XX**XX******XXXX*X*X**X*X*XXXX*****X********X*X*XX**X**X***XXX***X**
*X**X*X**X***XXX*X*X**X*X*X*XX*X***XX**XX*X******X**XX**X****X*XXX***XXXXXXX**X**X*X**X*XX*X***X**X*
**X***XX*X*X**X***X**XX*X*X****X*XX***X****XXXX*X*X***X*XX*X**X**XXXX********X**X**X*XX*X**XX*X*X*X*
X**XX**X*X**X**X*X**X***X*XXXXX**X**XXXXXXX****X***XX*X***X*X***X****X*XXXX*X**X*XX**X**X*X***X***X*
*X**X*X***X**X*X**X***X*X*******X*X***X****X*X**XX**X*X*X****X*XX*XX*X*X****X*X*****X**XX*X*XX**XXX*
**X**X**XX*X*X**X**XX*X**X*X*XXX***XX***XX**XXX****X**X*XX*X**X****X**X**X*X***XX*XX**XX**X**X*X****
X**X*X*X***XXX*X**X**X*X**X*X****X**X*XX**X**XXX*X*X*X*X***XXX**XX*X*X**X***XX**X*X**X***X**X**X*X*X
*X***X*X*X*****X*X**X***X*****XXXXX*X*XXX**X**X**X*X*X***XX****X**X**X*X**X**XX*X**X***XXX*X*X*X*X*X
**X*XX***XX*XXX**X*X**X**XXXXX***X**X**XX*X*X**X**X**XXX****XXXXX***X***XX*XX****X*X*XXX***X*X*X*X**
X*X*X*XX***X***X***X*XXX*****X*X**X**X****X***X**X**X***XX*X***X**X**XX*******XX***X*****XX****XX*X*
*******X*XX**X**XX*X**XXX*XXX***X*X*X*XXXX**XX*X*X*X**X***X**X**XX*X***XXXX*XX*XXXX*XX*X*X**X*X***X*
*XX*X*X***X*X*X*****X**X**X***X*XX**X******X*****X**X**XX***X*X*****X*X****X**********X*X**X*X**X*X*
***X*X**XX**X***XXX*XX**X***XXX***X***X*XXX**XX*X*X***X*XX*X***X*X*X****XX***XXXXX*XX*X**X*X***X****
*X*****X***X**XX***X***X*XXX***XX**XXXXX***XXX****XXXX****X**X**X**X*XXX***XX*****XXX**X*X*X*X**XXX*
*X*XX*X**X**XX***X***XX****XX*X**X*X**X**X****X*X****X*X*X**X**XX*X**X**X*X**X*XX**X**X**X*XXXX****X
X****X**X**X***XX*XXX***XX**X*X*XX**X***X**XX**XX*XX***X***XXX*X***X*XX**X**X****XXX*X**XX***X*X*X**
**X*X**X**X**XX*X*X***XX**X*X*****X***XXX*X**X*X**XXXXXX*XX*X***XX*X**XX***X**X*X****X*XX*XX****XXX*
*X*X**X*XXX*XX******XXX**X**X*X*X**XXX****XX*X*XX**X****XX***XX**X**X***XX***X**X*XXX**X***X*XX**X**
***X*X******X**XXXX****X***X***X*X****X*XX*X*X***X*X*XX*X**X**XX*X*X*XX***XXX**X**X***X**X**X**X**X*
XX*X***X*X*X*X*X***X*X**X*X**XX***X*X*X*X*****XX**X***X*X*XXX****X****X*XX****X**X**X***X*X**X***XX*
***XXXX*XXX***X**X**XXX*X*X*X***X**X**X**XX*XX*XX*X*X*X*X**XXXX*XXX*X*X****XX**X*XXX**X*X*XXX**XX***
*XX***X**X**X***X*X*XX**X*X**X*X*X***X*X**X********X**X**X**X****X*X**X*XXX**X*X***X*X*X*****X***X*X
**X*X**X***X*XXX******X*X**XXX****XX***X*X**XXXX*X*X*X*X**X*X*X*X****X*X****X***XX*X***X*XXX*XXX****
*X***X**X*X****XXXXXX***X*X***XXX***XXXX**X*X***X******XX***XX**X*XXX****XX*XX*X***X*X*X***X****XXX*
*X*X**X***X*XX******XXX*X*X*X*X***XX*****X****X**XXXXX**XXXX***X**X*X*X*X*X*****XX*XXX**XX**X*XX****
*XX**X*XX*X*X**XXXX****X****X*X*X*XX*X*X**XXXX**X****X*X****X*X**X**X*XX***XXXX**X****X***X*X****XXX
***X***XX*X**XX****X*X*XX*XX*****X***X*XXX***X*X**XX**X**XX**X**X**X***X*X****X*X*X*X**X*X***XXXX***
XX*XX*X***XX**X*XX*X*X***X**X*X*X**X**X****X*XX**X**X***XX*X*XX**X***XXX**XXX**X***X**X****XX****XX*
*X***XX*XX***X**X**X**XX**X**X**X*X**X**XXX***X*X*X**XXX***X***X**XXXX***X***X*X*X*X*X*X*XX***XX****
*XXX*X***X*X*X*X**X**X***XXX***X**X*X**X***XX*X***X*XX***X**X*X*X*X****XX*X*XX***X***X*****X*XX*X*X*
***X*X*XX***X**X*X**X**XX*XX*X*X*X**X*X**X*****XX*X****X*XX*X***X***X*X*****X*X*X*XXX*X*XX*X*X**X*X*
XX*X*X****X*X*XX**X*X*X*****XX*X**XX***X**X*XX**X**X*X*X***X**X*X*XX*X**XXX****X*******XXX*X***X**X*
***X*X*X*XXX**X*X*X*X***X*X***X*X**X*XX*X**X**X*XX**X*XXX*X**X***X*****X**XXXX***XXXXX**X***X*XXX**X
*X*X*X**X*X**XX*X**X*X*XX*XXX****X***X***X**X*****X****X**X*XX*XX**XXXXXX*****X*X*****X***XX***X*X**
**X**X*X****X****X****XX*****X*X**X*X**X*XX**XXX*X*X*X***XX***X*X*XX***X**X*X**X**XX*XXXXX***X****X*
X**X**X**XXX**XX*X*XX*X**XX*X**X*X**X*X****X****X***X*XX***XX***X****X**XX***X*X*X*X**X****XX*XXX*X*
*X**X**X*X***XX***X***XXX**X**XX**X***X*XX*XXX*X**X*****XX*X**X**X*XXXX***XXXX******X*X*X*X******X**
***X**XX*X*XXX**X**XX****X***X**X**X*X*XX****X*X*X*X*X*X***X*X*X**X**X*XX*****X*X*X*X****X**XXXX*X*X
X*X**X***X*X***X*X***XXX*X*X**X**X**X*****XXX**X*X*X**X**XXX****XX**X****XX*X**XX**X*X*X*X*X***X*X**
X*X*X*X*X***XXX**X*X***X**X*X**X*XX**X*XXXX***XX*X**X**X*X**X*X****X**XX***X*X*X**X***X**X**X*X***X*
**X*X***X*X****X****XXXXX***X*X***XX**X*****XX***X*X**X**X*XXX*XX*X**XX*XX***X*XX*X*X**X*X*X***X*X**
*X***X*XX*XXXX**XXXX***XX*XX**X*X***X*X*XXXX*X*XX**X*XX*X***X***X*X*X***X*X*X****X***X**XX*X*XXX***X
***X***X******X******X*******X***XX***X***********X*******X***X*X*****X***X***XX***X**X****X*****X**