*****XX****X********XXXX
XX******XX***XXXXX***XXX
XX***XXXX**XXXXX****XXXX
XX***XXXXaXXXXXXXXX****X
*****XXXXXX****XX***XXXX
XX*************XXXX*****