*****XX****X******XXXXXX
*******XX***XXXXX****XXX
XX***XXXX*
*XXXXX****XXXX
XX***XXXXXXXXXXXXXX****X
*****XXXXXX****XX***XXXX
XX*************XXXX*****